*******
*o    * 
* x** * 
*     *
*******
