*******
*o    * 
*  x  * 
*     *
*******
