*******
*o    * 
* x**** 
*     *
*******
